20 
30
0000000XXXXXXXXXXXXXXXXXXXXXXX
XXXXXX000XXXXXXXXXXXXXXXXXXXXX
XXXXXXXX0XXXXXXXXXXXXXXXXXXXXX
XXXXXXXX0000XXXXXXXXXXXXXXXXXX
XXXXXXXXXXX0XXXXXXXXXXXXXXXXXX
XXXXXXXXXXX0XXXXXXXXXXXXXXXXXX
XXXXXXXXXXX0XXXXXXXXXXXXXXXXXX
XXXXXXXXXXX000XXXXXXXXXXXXXXXX
XXXXXXXXXXXXX0XXXXXXXXXXXXXXXX
XXXXXXXXXXXXX0XXXXXXXXXXXXXXXX
XXXXXXXXXXXXX0XXXXXXXXXXXXXXXX
XXXXXXXXXXXXX00000000XXXXXXXXX
XXXXXXXXXXXXXXXXXXXX0XXXXXXXXX
XXXXXXXXXXXXXXXXXXXX00XXXXXXXX
XXXXXXXXXXXXXXXXXXXXX0XXXXXXXX
XXXXXXXXXXXXXXXXXXXXX0XXXXXXXX
XXXXXXXXXXXXXXXXXXXXX0XXXXXXXX
XXXXXXXXXXXXXXXXXXXXX0XXXXXXXX
XXXXXXXXXXXXXXXXXXXXXXXXXXXXXX
XXXXXXXXXXXXXXXXXXXXXXXXXXXXXX
