8
8
BBXBBBXB
XBXBXBXB
XBXBXBXB
XBBBXBXB
BBXXXBBB
BXXBBBXX
BXXBXXXX
BXXBBBBB
